Device.IP.Diagnostics.IPPing.DiagnosticsState	RW	str
Device.IP.Diagnostics.IPPing.Host	RW	str
Device.IP.Diagnostics.IPPing.NumberOfRepetitions	RW	unsignedInt
Device.IP.Diagnostics.IPPing.Timeout	RW	unsignedInt
Device.IP.Diagnostics.IPPing.DataBlockSize	RW	unsignedInt
Device.IP.Diagnostics.IPPing.SuccessCount	R	unsignedInt
Device.IP.Diagnostics.IPPing.FailureCount	R	unsignedInt
Device.IP.Diagnostics.IPPing.AverageResponseTime	R	unsignedInt
Device.IP.Diagnostics.IPPing.MinimumResponseTime	R	unsignedInt
Device.IP.Diagnostics.IPPing.MaximumResponseTime	R	unsignedInt
Device.ManagementServer.EnableCWMP	RW	boolean
Device.ManagementServer.URL	RW	str
Device.ManagementServer.Username	RW	str
Device.ManagementServer.Password	RW	str
Device.ManagementServer.PeriodicInformEnable	RW	boolean
Device.ManagementServer.PeriodicInformInterval	RW	unsignedInt
Device.ManagementServer.PeriodicInformTime	RW	dateTime
Device.ManagementServer.ConnectionRequestURL	R	str
Device.ManagementServer.ConnectionRequestUsername	RW	str
Device.ManagementServer.ConnectionRequestPassword	RW	str
Device.ManagementServer.ParameterKey	R	str
Device.IP.Interface.1.Enable	R	boolean
Device.IP.Interface.1.Status	R	str
Device.IP.Interface.1.Name	R	str
Device.IP.Interface.1.Type	R	str
Device.IP.Interface.1.IPv4AddressNumberOfEntries	R	unsignedInt
Device.IP.Interface.1.IPv4Address.1.IPAddress	RW	str
Device.IP.Interface.1.IPv4Address.1.AddressingType	R	str
Device.IP.Interface.1.IPv4Address.1.Enable	R	boolean
Device.IP.Interface.1.IPv4Address.1.Status	RW	str
Device.IP.Interface.1.IPv4Address.1.SubnetMask	R	str
Device.IP.Interface.1.Stats.BytesSent	R	unsignedInt
Device.IP.Interface.1.Stats.BytesReceived	R	unsignedInt
Device.IP.Interface.1.Stats.PacketsSent	R	unsignedInt
Device.IP.Interface.1.Stats.PacketsReceived	R	unsignedInt
Device.IP.Interface.1.Stats.ErrorsSent	R	unsignedInt
Device.IP.Interface.1.Stats.ErrorsReceived	R	unsignedInt
Device.IP.Interface.1.Stats.DiscardPacketsSent	R	unsignedInt
Device.IP.Interface.1.Stats.DiscardPacketsReceived	R	unsignedInt
Device.GatewayInfo.ManufacturerOUI	R	str
Device.GatewayInfo.ProductClass	R	str
Device.GatewayInfo.SerialNumber	R	str
Device.UserInterface.RemoteAccess.Enable	RW	boolean
Device.UserInterface.RemoteAccess.Port	R	unsignedInt
Device.UserInterface.RemoteAccess.Protocal	R	str
Device.UserInterface.RemoteAccess.SupportedProtocal	R	str
Device.Time.Enable	RW	boolean
Device.Time.Status	R	str
Device.Time.NTPServer1	RW	str
Device.Time.NTPServer2	RW	str
Device.Time.NTPServer3	RW	str
Device.Time.NTPServer4	RW	str
Device.Time.NTPServer5	RW	str
Device.Time.CurrentLocalTime	R	dateTime
Device.Time.LocalTimeZone	RW	str
Device.DeviceInfo.SpecVersion	R	str
Device.DeviceInfo.ProvisioningCode	RW	str
Device.DeviceInfo.Manufacturer	R	str
Device.DeviceInfo.ManufacturerOUI	R	str
Device.DeviceInfo.ProductClass	R	str
Device.DeviceInfo.ModelName	R	str
Device.DeviceInfo.ModelNumber	R	str
Device.DeviceInfo.SerialNumber	R	str
Device.DeviceInfo.HardwareVersion	R	str
Device.DeviceInfo.SoftwareVersion	R	str
Device.DeviceInfo.DeviceCategory	R	str
Device.DeviceInfo.Description	R	str
Device.DeviceInfo.UpTime	R	unsignedInt
Device.DeviceInfo.DeviceLog	R	str
Device.DeviceInfo.MemoryStatus.Total	R	str
Device.DeviceInfo.MemoryStatus.Free	R	str
Device.Ethernet.InterfaceNumberOfEntries	R	unsignedInt
Device.Ethernet.LinkNumberOfEntries	R	unsignedInt
Device.Ethernet.Interface.1.Name	R	str
Device.Ethernet.Interface.1.Enable	RW	boolean
Device.Ethernet.Interface.1.Status	R	str
Device.Ethernet.Interface.1.MACAddress	R	str
Device.Ethernet.Interface.1.CurrentBitRate	R	unsignedInt
Device.Ethernet.Interface.1.DuplexMode	RW	str
Device.Ethernet.Interface.1.Stats.BytesSent	R	unsignedLong
Device.Ethernet.Interface.1.Stats.BytesReceived	R	unsignedLong
Device.Ethernet.Interface.1.Stats.PacketsSent	R	unsignedLong
Device.Ethernet.Interface.1.Stats.PacketsReceived	R	unsignedLong
Device.Ethernet.Interface.1.Stats.ErrorsSent	R	unsignedInt
Device.Ethernet.Interface.1.Stats.ErrorsReceived	R	unsignedInt
Device.Ethernet.Interface.1.Stats.DiscardPacketsSent	R	unsignedInt
Device.Ethernet.Interface.1.Stats.DiscardPacketsReceived	R	unsignedInt
Device.Ethernet.Link.1.Name	R	str
Device.Ethernet.Link.1.Enable	RW	boolean
Device.Ethernet.Link.1.Status	R	str
Device.Ethernet.Link.1.MACAddress	R	str
Device.Ethernet.Link.1.PriorityTagging	RW	boolean
Device.Ethernet.Link.1.Stats.BytesSent	R	unsignedLong
Device.Ethernet.Link.1.Stats.BytesReceived	R	unsignedLong
Device.Ethernet.Link.1.Stats.PacketsSent	R	unsignedLong
Device.Ethernet.Link.1.Stats.PacketsReceived	R	unsignedLong
Device.Ethernet.Link.1.Stats.ErrorsSent	R	unsignedInt
Device.Ethernet.Link.1.Stats.ErrorsReceived	R	unsignedInt
Device.Ethernet.Link.1.Stats.DiscardPacketsSent	R	unsignedInt
Device.Ethernet.Link.1.Stats.DiscardPacketsReceived	R	unsignedInt
Device.NAT.PortMapping.1.Enable	RW	boolean
Device.NAT.PortMapping.1.Status	R	str
Device.NAT.PortMapping.1.Alias	RW	str
Device.NAT.PortMapping.1.Interface	R	str
Device.NAT.PortMapping.1.AllInterfaces	R	str
Device.NAT.PortMapping.1.LeaseDuration	RW	str
Device.NAT.PortMapping.1.RemoteHost	RW	str
Device.NAT.PortMapping.1.ExternalPort	RW	unsignedInt
Device.NAT.PortMapping.1.ExternalPortEndRange	R	unsignedInt
Device.NAT.PortMapping.1.InternalPort	RW	unsignedInt
Device.NAT.PortMapping.1.Protocal	RW	str
Device.NAT.PortMapping.1.InternalClient	RW	str
Device.NAT.PortMapping.1.Description	R	str
Device.User.User.1.Enable	RW	boolean
Device.User.User.1.Password	RW	str
Device.User.User.1.RemoteAccessCapable	R	boolean
Device.User.User.1.Username	R	str
Device.Firewall.Enable	RW	boolean
Device.Firewall.Config	RW	str
Device.Firewall.AdvancedLevel	RW	str
Device.Firewall.Type	RW	str
Device.Firewall.LevelNumberOfEntries	RW	unsignedInt
Device.Firewall.Level.1.Chain	RW	str
Device.Firewall.Level.1.DefaultLogPolicy	RW	boolean
Device.Firewall.Level.1.DefaultPolicy	RW	str
Device.Firewall.Level.1.Order	RW	unsignedInt
Device.Firewall.Chain.1.Rule.1.Alias	RW	str
Device.Firewall.Chain.1.Rule.1.Description	R	str
Device.Firewall.Chain.1.Rule.1.DestInterface	RW	str
Device.Firewall.Chain.1.Rule.1.DestPort	RW	int
Device.Firewall.Chain.1.Rule.1.DestPortRangeMax	RW	int
Device.Firewall.Chain.1.Rule.1.DSCP	RW	int
Device.Firewall.Chain.1.Rule.1.Enable	RW	boolean
Device.Firewall.Chain.1.Rule.1.IPVersion	RW	int
Device.Firewall.Chain.1.Rule.1.Order	RW	unsignedInt
Device.Firewall.Chain.1.Rule.1.Protocal	RW	int
Device.Firewall.Chain.1.Rule.1.SourceIP	RW	str
Device.Firewall.Chain.1.Rule.1.SourceMask	RW	str
Device.Firewall.Chain.1.Rule.1.SourcePort	RW	int
Device.Firewall.Chain.1.Rule.1.SourcePortRangeMax	RW	int
Device.Firewall.Chain.1.Rule.1.Status	RW	int
Device.Firewall.Chain.1.Rule.1.Target	RW	str
Device.DHCPv4.Server.Enable	RW	boolean
Device.DHCPv4.Server.PoolNumberOfEntries	R	unsignedInt
Device.DHCPv4.Server.Pool.1.Enable	RW	boolean
Device.DHCPv4.Server.Pool.1.Status	R	str
Device.DHCPv4.Server.Pool.1.Interface	RW	str
Device.DHCPv4.Server.Pool.1.MinAddress	RW	str
Device.DHCPv4.Server.Pool.1.MaxAddress	RW	str
Device.DHCPv4.Server.Pool.1.SubnetMask	RW	str
Device.DHCPv4.Server.Pool.1.DNSServers	RW	str
Device.DHCPv4.Server.Pool.1.DomainName	RW	str
Device.DHCPv4.Server.Pool.1.IPRouters	RW	str
Device.DHCPv4.Server.Pool.1.LeaseTime	RW	int
Device.WiFi.RadioNumberOfEntries	R	unsignedInt
Device.WiFi.SSIDNumberOfEntries	R	unsignedInt
Device.WiFi.AccessPointNumberOfEntries	R	unsignedInt
Device.WiFi.Reset	RW	boolean
Device.WiFi.Radio.1.Enable	RW	boolean
Device.WiFi.Radio.1.Status	R	str
Device.WiFi.Radio.1.Name	R	str
Device.WiFi.Radio.1.SupportedFrequencyBands	R	str
Device.WiFi.Radio.1.OperatingFrequencyBand	R	str
Device.WiFi.Radio.1.OperatingStandards	RW	str
Device.WiFi.Radio.1.ChannelsInUse	R	str
Device.WiFi.Radio.1.Channel	RW	unsignedInt
Device.WiFi.Radio.1.AutoChannelSupported	R	boolean
Device.WiFi.Radio.1.AutoChannelEnable	RW	boolean
Device.WiFi.Radio.1.MaxSupportedSSIDs	R	unsignedInt
Device.WiFi.Radio.1.MaxSupportedAssociations	R	unsignedInt
Device.WiFi.Radio.1.FirmwareVersion	R	str
Device.WiFi.Radio.1.SupportedOperatingChannelBandwidths	R	str
Device.WiFi.Radio.1.OperatingChannelBandwidth	RW	str
Device.WiFi.Radio.1.CurrentOperatingChannelBandwidth	R	str
Device.WiFi.Radio.1.ExtensionChannel	RW	str
Device.WiFi.Radio.1.GuardInterval	RW	str
Device.WiFi.Radio.1.TransmitPowerSupported	R	str
Device.WiFi.Radio.1.TransmitPower	RW	str
Device.WiFi.Radio.1.RegulatoryDomain	RW	str
Device.WiFi.Radio.1.FragmentationThreshold	RW	unsignedInt
Device.WiFi.Radio.1.RTSThreshold	RW	unsignedInt
Device.WiFi.Radio.1.BeaconPeriod	RW	unsignedInt
Device.WiFi.Radio.1.DTIMPeriod	RW	unsignedInt
Device.WiFi.Radio.1.PacketAggregationEnable	RW	boolean
Device.WiFi.SSID.1.Enable	RW	boolean
Device.WiFi.SSID.1.Status	R	str
Device.WiFi.SSID.1.Name	R	str
Device.WiFi.SSID.1.LowerLayers	RW	str
Device.WiFi.SSID.1.SSID	RW	str
Device.WiFi.SSID.1.BSSID	R	str
Device.WiFi.SSID.1.MACAddress	R	str
Device.WiFi.SSID.1.X_IPInterface	RW	str
Device.WiFi.AccessPoint.1.Enable	RW	boolean
Device.WiFi.AccessPoint.1.Status	R	str
Device.WiFi.AccessPoint.1.SSIDReference	R	str
Device.WiFi.AccessPoint.1.Security.ModesSupported	R	str
Device.WiFi.AccessPoint.1.Security.ModeEnabled	RW	str
Device.WiFi.AccessPoint.1.Security.WEPKey	RW	hexBinary­
Device.WiFi.AccessPoint.1.Security.PreSharedKey	RW	hexBinary­
Device.WiFi.AccessPoint.1.Security.KeyPassphrase	RW	str
Device.WiFi.AccessPoint.1.AssociatedDevice.1.MACAddress	R	str
Device.WiFi.AccessPoint.1.AssociatedDevice.1.OperatingStandard	R	str
Device.WiFi.AccessPoint.1.AssociatedDevice.1.AuthenticationState	R	str
Device.WiFi.AccessPoint.1.AssociatedDevice.1.LastDataDownlinkRate	R	str
Device.WiFi.AccessPoint.1.AssociatedDevice.1.LastDataUplinkRate	R	str
Device.WiFi.AccessPoint.1.AssociatedDevice.1.AssociationTime	R	str
Device.WiFi.AccessPoint.1.AssociatedDevice.1.SignalStrength	R	str
Device.WiFi.AccessPoint.1.AssociatedDevice.1.Active	R	str
